Bhutan - Thimphu
Botswana - Gaborone
Brazil - Brasilia
Bulgaria - Sofia
Burma - Rangoon
Burundi - Bujumbura
Cameroon - Yaounde
Canada - Ottawa
Chad - N'Djamena
Chile - Santiago
China - Beijing
Colombia - Bogota
Comoros - Moroni
Croatia - Zagreb
Cuba - Havana
Cyprus - Nicosia
Denmark - Copenhagen
Djibouti - Djibouti
Dominica - Roseau
Ecuador - Quito
Egypt - Cairo
Eritrea - Asmara
Estonia - Tallinn
Fiji - Suva
Finland - Helsinki
France - Paris
Gabon - Libreville
Georgia - Tbilisi
Germany - Berlin
Ghana - Accra
Greece - Athens
Guinea - Conakry
Haiti - Prince
Honduras - Tegucigalpa
Hungary - Budapest
Iceland - Reykjavik
India - NewDelhi
Indonesia - Jakarta
